00011111111111111000
00012222222222221000
00012222222222221000
00012222222222221000
00012222222222221000
00012222222222221000
00012222222222221000
00012222222222221000
11112222222222221111
22222222222222222222
22222222222222222222
22222222222222222222
11112222222222221111
00012222222222221000
00012222222222221000
00012222222222221000
00012222222222221000
00012222222222221000
00012222222222221000
00011111111111111000